####################
#                  #
#  ###{=----}###   #
#     |,    |      #
####  [--}  |   ####
#        |  |      #
# #######|x#####   #
#   #{-+-]c###     #
Ee  #|   CCC       #
DFA{-]             #
####################
