## #################
# F            x   #
#            x     #
#    C #}          #
#     C#|          #
#    C #|      c;*,#
#  x  C#[--=----+=-#
#      #############
#                 Ee
#                  D
####################
