# # # # # # # # # Ee
 #,# # # # # # # # D
# # # # # # # # # # 
 # # # # # # # # # #
# # # # # # # # # # 
 # # # # # # # # # #
# # # # # # # # # # 
 # # # # # # # # # #
# # # # # # # # # # 
 # # # # # # # # # #
F# # # # # # # # # #
