#Ee#################
#DD#################
# F                #
#                  #
###############CC  #
#    ,    , ;   #  #
#      ,       ##  #
# ### ### ### ##   #
#*#   #x  #  x#    E
#;# x #   #   #    D
####################
