  #######DD#######  
   #      F      #  
   #             #  
   #   x   ;;,CCC#  
  ####### ,**;CCC#  
  CCCCCCC ****CCC#  
  ####### ,,;,CCC#  
   #x  x    x CCC#  
   #     x     x #  
   #          x  #  
  #######DD#######  
