##################Ee
#  ,,,,,  ,,,,     #
#  ##### ,####,    #
#  ##,,, ## ,##    #
#  ####, ##,###    #
#  ,,,## ### ##    #
#  ##,## ##,,##    #
#   ###   ####     #
#                  #
F                  #
####################
