##################Ee
#A     C      x   ,D
#      C       x   #
#      #          c#
#CCCCCC#          c#
########         cC#
#                  #
#  #               #
#  #          ######
F  #          #OOOO 
###############     
