##################Ee
#                  #
#                  #
#                  #
#                  #
#                  #
#                  #
#                  #
#                  #
F                  #
####################
