                    
 ################Ee 
 #    OCC         # 
 #     CCC    *   # 
 #      CCCO      # 
 #      OCCC      # 
 #        CCCO    # 
 #   x x   CCC    # 
 F  x x     CCC   # 
 ################## 
                    
