####################
#                  #
#                 x#
###A#              #
Ee################ #
D  F             C #
#                C #
################## #
#,   O    xCCc  x  #
#      O  xCCC     #
####################
