#[-+-]###Ee#########
#* c    #DD#      A#
#*C CC  # x# CC  c #
#;CCCC  c    CCCC  #
#,CCCCc  c c  Cxcc #
# CCCCC      CCCC  #
}                  #
:    ##########    #
]    OOOOOOOOOO    #
#;       F         #
####################
