####################
#       x      x   #
#   x    {------}x E
# {------]    x |  D
# +        x    |  #
# |  x  {-----} |x #
# [==---]x{---] +  #
#  ,     C|     |  #
#{--------] +---]  #
#| F A        x    #
##DD################
