####################
#        OCCc*#,  O#
#    x   OCCCc#    #
######        #   O#
#CCCCC  #######    #
#       #Ee#    x O#
#       # F#       #
# x #   # ##  ######
#   #              #
#OOO#            x #
####################
