##################Ee
F        ##      ,*D
#######  ##  #######
#x      *##        #
#   ############  ;#
#*       ##        #
#######  ##  #######
#       ;##*       #
#   ############   #
#         ,        #
####################
